nof: eyx uhp xte jod eza
mwc: nim uzu
pvn: soo asm dwc dng
jlm: xvz wps
vol: out
yme: cls fnw noh xjd
gqq: ddt vca
wdh: qnz
jci: cas fis tei
iye: whf emr gon
fki: szn
phk: vwv gti mmw rdu
omy: fft
roq: gco pdi
ydd: low tsb wfg
emr: vvf pox
boz: nof zbf wyd via
hhk: pph ecy
wps: rrl lnz
ppg: rrw riz
tsb: nhg msm col roq igt
nzt: lgf nlo efp pjd
fty: ddt ohq
prh: nvk fuj ukz vjp
ewy: peb uin szn
fvk: pvn
gfd: htq
ihv: uin peb giz
gtp: bwy odn klq
uib: oee upe dqp qqp
awq: fft
zmp: out
xvm: szn
isu: jly gtp jkc
gvx: fri myu
klq: ddt
wcq: mpk
wyd: xte eyx
eoz: jkc
eej: opc
swg: uib bdm bzl
gco: wug
fqo: vca ohq ddt
xtu: aqo lgf efp
fnw: qef qsj jzi
fkd: nre egs tfy opc
nxg: gcj lhz
svq: wrh dbk
mwh: kvs ttm prq
bdm: oee rdb qqp dqp
vnv: sfq ypd rgb evb
yev: uin peb szn
uzu: ttm prq
mpk: rgb bsm sfq
thy: lhc dbk wrh
peb: uvz awq omy
gqw: mfg htl chj
znz: iye qyx
xtq: out
nre: xny
rgb: out
hwu: mia
kuc: out
vod: xvm ywx
whf: xah ebp qmc
zls: iye
iof: bqw jci
awj: giz uin peb
xwe: dwi ked vol
zff: wbj qnd rlk zqk
zuv: cyj mhl vhq eoz qen mvu vph xxq dwr lkh lxb
wgj: xix wup
krs: nek vod qfp
are: out
jpm: ohq ddt
dwc: mwh nim mvn uzu
sqv: jtv pph
asm: xbp mwh
ebj: wup xix
cqp: sjl tpb
bzm: bnd obu ujx
ypd: out
jos: nim mwh xbp uzu mvn
kwl: vpi dfk bag
mdc: vub sfy
egs: bsx xny
fft: iss cqp oyh
vwv: bmd mfg
myu: mwh uzu xbp
sfy: myu fri
msm: pdi
sjl: wot vhq hze lkh isu qen dwr jlm ewe ndz vis vph kwl
vuo: nim uzu
imf: szn
xvz: bei
riz: boz lur
tnz: ysk
ukz: iwf
bli: stz mvb xpt knd fap
iba: rlk qnd
vkf: fuj vjp
mvu: anb yme
ndt: vca
soo: uzu mvn
cxu: mdc ubx
vub: myu
qmc: bvs mig
fnt: cts ucz
npf: mpk ztd rur
luk: vqs lhm ita
obu: vqs lhm sbh
jod: zmp zlc ujj
ixf: omc
vka: mwh xbp mvn uzu
qyx: lcr
lie: boz lur
vca: mwi jzb cfx ann iof kso wko bhk dph bip din vbb tyu dnz grp zyv vnj sat phk
zlc: out
ops: lgk dwi ked
ewe: vpi dfk sfi
wot: abc
rao: xix wup
xww: nls cab fza
qrz: fki ihv
lur: zbf nof wyd
ucg: dac
yxn: vca
nek: wrh xvm ywx lhc
gnn: rur
dph: rdu gqw vwv
cgf: knd stz mvb
afm: kuc
wmr: rao pzz ebj wgj
icu: adb bkm
bnd: vqs sbh ita
din: ltl sqv
jtv: bmi vuo vka
gbi: xbp uzu nim
uqx: peb uin giz
zbt: myu
lkf: qfp thy svq nek vod
qen: icu
svr: pxq fmq ggx ora
fis: mwh xbp mvn uzu
cif: qwn are
noh: jzi qsj qyy
haf: rrw
lsp: uzu xbp mwh nim
bld: jzi qsj qyy
cab: syq ahg
qsi: aqo nlo
uhp: zmp
ggx: dzu pci rxt gpo krs swg dxm nzt lkf xtu fnt
jow: kzq uwv fkb kuc
pxq: vay ftt nzt lkf fnt xtu sju zpf ydd qsi dxm gnw rxt dzu pci lml rfx swg fkw gpo
fmq: rxt pci dzu lml rfx swg fkw krs gpo vay ftt xtu fnt nzt sju qsi ydd dxm ipw
jvw: qbp wdh bkm adb tlj
rxt: bdm amb
xbp: kvs pyl
ufz: jry uqx jbq
crg: yhm
cvy: rbc jli
kmw: dac
fkb: out
ubu: ysk cvy yhm
gmc: xjj fkd
tei: mvn xbp uzu nim
jry: giz szn uin peb
vqs: oll hpc
ecy: bmi vuo vka
jbq: giz uin peb szn
glj: qen dwr lkh isu lxb mqn mhl cwp wot eoz vhq mvu vph kwl ndz cyj vis jlm
tfy: ezo yal bsx
chj: nxg cai
xix: jbq
rfx: vod nek thy svq
qot: tlj bkm adb qbp wdh
zqk: ddt
dxg: ihv nvz bjp
mig: are xtq
xyi: nxg
you: zls gfh ebt xww lta iwq
jli: xun ixf
mhl: jvw abc icu qot
vph: icu abc qot
giz: uvz awq
ucz: rao pzz tvm wgj
anb: bld fnw
gpo: mro cys gmc
bwy: ohq
htl: uui cai
sfi: htq cgf
htq: mvb stz xpt knd
nlo: bok
xah: bvs
bzl: upe dqp qqp
uok: lxm sfy zbt
gfh: ysk cvy
qnz: rlk zqk
vvf: cif jgt
oll: ked vol lgk
abc: adb bkm qbp wdh
bkm: iba
lgf: poe sff bok
upe: flz
cts: tvm pzz rao wgj
xpt: fqo
riu: prh bad vkf
bbw: vnv
eyx: zlc yah ujj
ost: soo mwc
mvb: fqo aqj mtg
hpc: lgk
bsx: giz
rdu: xyi
col: pdi gco
lgk: out
dwi: out
via: jod
lml: tsb wfg
xte: zmp yah ujj
wko: jvc
qwn: out
wbj: ohq
fza: ahg ipk
uui: gbi
tlj: zff iba
ysk: opr
gnw: pjd efp lgf aqo
rdb: dxg qrz dqj
wup: jry
opc: bsx yal
mmw: htl chj mfg
qsj: wlx jpm gqq
dng: mwh xbp uzu
jzb: sqv hhk
kzq: out
mwi: zav bqw
ita: ops oll hpc xwe sjz
dqj: nvz bjp fki
gti: chj xyi
uwv: out
ezo: szn
bmi: mvn mwh
dnz: pvn ost
dqp: flz dqj qrz
eqw: fki bjp ihv
zav: fis cas
low: roq col nhg msm
xjj: tfy
cas: mwh nim uzu mvn xbp
bhk: cxu
rhb: bzm eqn
bjp: uin peb szn giz
mvn: prq pyl kvs
jmz: fza
ahg: gnn bbw wcq ryt npf
tza: lur
oee: flz qrz
hqg: szn peb giz
bvs: qwn
pzz: xix ufz
rur: bsm rgb
bag: bli htq cgf
vay: fop
dwr: bag sfi vpi dfk gfd
lta: fza cab nls
dzu: wmr ucz cts
ftt: cys mro
nhg: gco pdi ksk
vzi: nim mvn
pci: bdm uib amb
xny: szn uin
yal: szn peb
bok: bxd yev awj
vnj: rku cxu
pin: lnz rrl ndt
qfp: dbk xvm lhc
gcj: nim mwh mvn xbp
jgt: are qwn xtq
iss: sjl glj zuv
pdi: ewy qck hqg
sat: pvn ost
nim: kvs ttm
sff: bxd imf yev
ann: ltl
tvm: ufz
mpv: ukz
hze: xvz pin
nvk: lsp iwf
fyq: ubx uok
dxm: low
cfx: pvn qwh
kvs: ucg
qnd: ohq ddt vca
wlx: ddt vca
wfg: igt nhg roq col
rku: mdc
jzi: yxn gqq jpm
jkc: klq
cyj: deu
adb: zff iba
efp: bok poe
szn: uvz omy
xxq: dfk vpi sfi
iwf: mvn xbp nim
qwh: dwc dng soo asm
qef: wlx jpm
ndz: gfd
zyv: sqv
mqn: abc
guz: bzm eqn rwc
dac: rgn rjk ani
ltl: jtv ecy pph
evb: out
aqo: bok
odn: ddt vca
sbh: sjz oll ops xwe hpc
rgn: you bhi qsg mpm
ipw: cts wmr
qyy: jpm
aqj: vca
knd: aqj
opr: xnh xun ixf
mfg: cai
xjd: qyy qef qsj jzi
ebp: jgt
pox: bvs cif
ipk: npf ryt
kso: riu jvc mia
tev: wyd via
vis: pin wps xvz
lhz: mvn uzu
fap: aqj mtg
cwp: anb uhs yme
cai: gcj
qqp: eqw
lkh: uhs anb
amb: oee rdb qqp dqp
rbc: xnh
fkw: gmc
lxm: vzi
bad: nvk vjp
ohq: iof ann cfx bop mwi dnz utv tyu sat grp bip dph hwu bhk wko kso fvk vbb din
cls: qsj qyy qef
qck: giz szn peb
ksk: qck
ryt: rur ztd mpk vnv
dfk: htq
bxd: peb uin giz
syq: gnn bbw wcq ryt
jvc: mpv bad vkf prh
lxb: wps pin xvz
deu: klq odn bwy enc
lhc: uin
grp: vwv gqw mmw
cys: xjj eej qps
rjk: jat you qsg mpm bhi
vbb: fyq rku cxu
lnz: vca ohq
vhq: deu gtp jkc
rwc: ujx bnd obu
qbp: iba
nls: ipk
pjd: bok
wug: uin peb
zbf: uhp eyx
fop: qps xjj
lhm: oll ops
ztd: sfq ypd rgb evb
anp: eqn
flz: bjp
bmd: uui cai nxg
vjp: iwf lsp jos
oyh: zuv sjl glj
xnh: jow nsi afm
ani: you jat qsg mpm
sfq: out
pyl: kmw ucg
ora: krs fkw qsi lkf sju lml rfx gnw rxt pci
eza: zlc ujj
rrl: ddt ohq vca
eeh: tnh
ebt: cvy yhm ysk
bhi: anp xww haf jmz crg
ywx: uin giz
rlk: vca
bop: bqw
vpi: bli htq cgf
fri: nim mwh uzu xbp
nsi: uwv fkb kuc kzq
jly: fty bwy odn enc
lcr: ebp pox xah vvf
fuj: jos
bei: ohq
mtg: ddt
nvz: giz
mia: mpv prh bad vkf
iwq: eqn rwc
hhq: tza rrw lie riz
omc: fkb
wrh: peb giz
bsm: out
utv: ltl hhk
dbk: peb
rrw: tev
pph: bmi vka
enc: ohq vca
yah: out
bqw: tei fis
tnh: emr gon
stz: mtg aqj
tyu: vwv gqw rdu
mro: xjj fkd eej
jat: iwq guz ppg jmz hhq haf xww ubu tnz ebt
ddt: jzb bop iof ann din vbb fvk wko bip hwu grp zyv vnj sat phk dnz
gon: qmc ebp xah
mpm: hhq xww haf jmz iwq rhb crg lta ubu tnz zls gfh ebt guz znz eeh ppg
ttm: kmw
ujj: out
ubx: gvx zbt lxm sfy
sju: mro fop cys
ujx: vqs lhm sbh
poe: bxd awj yev
xun: nsi omc jow afm
yhm: opr rbc
uhs: noh cls bld
uin: uvz
eqn: luk bnd
tpb: cwp mhl ndz vis eoz jlm wot qen isu
sjz: ked vol dwi lgk
qps: opc nre egs
ked: out
qsg: eeh tnz hhq
igt: ksk gco
bip: pvn
prq: ucg
uvz: fft
zpf: svq nek
